+------------------+
|                  |
|  X     >         |
|  X               |
|  XXXXXXXXXX      |
|           X      |
|                X |
+------------------+
(0,0) (10,10)
(10,10) (20, 10)
