+-------------------------------+
| >                             |
|                               |
|                               |
|                               |
|                               |
|                               |
+-------------------------------+
(1,1) (10,2)
(5,5) (10,5)
