+---------------------+
|                     |
|                     |
|>                    |
|                     |
|                     |
|                     |
|                     |
|                     |
+---------------------+
(2,3) (5,7)
(5,7) (8,7)
(8,7) (11,3)
