+------------------+
|                  |
|  X     >         |
|  X               |
|  XXXXXXXXXX      |
|           X      |
|                  |
+------------------+
(12,2) (15,4)
(15,4) (17,4)
(17,4) (19,6)
